m000000000
0110101010
0100000000
0000000010
0101010101
0000000001
0101010100
0100000101
0101010101
000000000e
