111111111111111
100000001000001
101000101011101
e01000001011100
101011100001011
001010000100111
001010000100111
011111010000001
001110000100111
111m10000100000
000010100001000
000000000001000
001110000001000
000011110001000
000000000001000